11111111111111111111111111111111111111111111111111111111111111111111111111111111
10000000000011110000000000000000000000000000000000000000000000000000000000000001
10111110000000011110101100001000000000000000000000000000000000000000000000000001
10100011110000000011010010100100000000000000000000001000000000000000000000000001
1010E000100000000000101101001000000000010000000000010000000000000000000000000001
10100000011000000000011000001001000000110000000000100000000000000000000000000001
10100000000110000000000111101000001001100000000001000000000000000000000000000001
10000000001001110000000000011111000011000000000010000000000000000000000000000001
110000000110000001110C0000000000100000110000000100000000000000000000000000000001
10000011000000000011110000000000001000001000000100000000000000000000000000000001
11111000000000000000011100011000011000111111111111111111111100000000000000000001
10000000000000000000000100000000111000001000001000000000000000000000000000000001
10000000000000000000000100000011111110001001111111111111111111000000000000000001
10000000000000000000001100110011111110101110000000000000011111111111111100000001
10000011111111111111111100110001110010000010000000000000000000000000000000000001
10000000000000000011111100110000111010000100000000000000000000000000000000000001
10001111111111111111111100000001110100000100000000000000000000000000000001000001
10000000001111111111111100000010111110000100000000000000000000000000000001010001
10000110000000000000000011100001100010010100000000000000000000001010000001001001
100111000001111111111111111110CCC10000010100000000000000000000001110101001000001
10111000000000000000000000000111CC1000010100000000000000000000001110101001000001
111110000000000000000000000000011C0100000101110000000000000000001111111111111111
11110000000000000000011111111111000010000001000100000000000000000001000010001001
11110000000000000001000000111000000001100001010001000000000000000100010100000001
11110000000000000001100001110000000000011000000000100100000000000000000000000001
11111111000000000001111111111111100000000110000000000010000000000000000000000001
1000011111000000000000000000000001110000C001111110000000001111100000000000000001
10000000111111000000000000010000100011100000000001111111111000010000000000000001
10000000000111100000000000010011000000000000011000000000000100001000000100100001
10000000000000000000111111111100001100000000000000000000111000000100000111100001
10000000000000000000000000000111001000001110000000001111100000000010000111100001
100000000000000000000000000000001111000000000CCC00111111111111111111111111110001
10000000000000000000000000000000000011111110000000000000000000001110000111111111
111101111111111111111111111111111000000000011111000000C0000000000100000000000001
1111011111111111111111111111111111111111111111111000000000000000001000000P0C0001
10000001111111111111111111111111111111111111111111110000000000000000000000000001
11110111111000000000000000000000000001111111110000011100000000000000000000000011
10000000000000000000000000000000000000000000000000000000001110000000100001110111
11111111111111111111111111111111111111111111111111111111111111111111111111111111
