1111111111111111111111111111
1P00000000000000011111111111
11111110000CCC00000111111111
111110000CCCCCC0000001111111
11110000CCCCCCCCC00000011111
1110000CCCCCCCCCC00000001111
110000CCCCCCCCCCC00000000111
10000CCCCCCCCCCCCC000CC00111
1000CCCECCCCCCCCCCC0CCC00011
100CCCCCCCCCCCCCCCCCCCC00011
100CCCCCCCCCCCCCCCCCCCC00011
100CCCCCCCCCCCCCCCCCCCC00011
1100CCCCCCCCCCCCCCC00CC00011
11100CCCCCCCCCCCCC0000000111
111100CCCCCCCCCCC00000000111
1111100CCCCCCCC0000000001111
1111110000CCCCC0000000011111
11111110000CCC00000000111111
1111111110000000000011111111
1111111111111111111111111111
