111111111111111111111111111111
10000C11C0000CCCC0000C11C00001
10000C11C0000C11C0000C11C00001
10000CCCC0000CCCC0000CCCC00001
1CCCC0000CCCC0000CCCC0000CCCC1
1C11C0000CCCC0000CCCC0000C11C1
1CCCC0000CCCC0000CCCC0000CCCC1
10000CCCC0000CCCC0000CCCC00001
10000CCCC0000CCCC0000CCCC00001
10000CCCC0000CCCC0000CCCC00001
1CCCC00001111000011110000CCCC1
1C11C0000CCCC0EP0CCCC0000C11C1
1CCCC00001111000011110000CCCC1
10000CCCC000011110000CCCC00001
10000CCCC000011110000CCCC00001
10000CCCC000011110000CCCC00001
1CCCC0000CC1C0000C1CC0000CCCC1
1C11C0000C1CC0000CCCC0000C11C1
1CCCC0000CCCC0000CC110000CCCC1
111111111111111111111111111111
