111111111111111111111111111111111111111111111111111111111111111111111111111111111111111111111111111111111111111111111111111111111111111
1111110100011100000111101110000011000000000000000111111100000000000011100000000100000000001000000000101100000110010100100100111010101E1
10P000000C0000000000C0000000000C0000000C0000C000000C000C00000C00C00C000000000C000000C000000000C0000C000000000C00000000C00C000C000CC0001
100000000000000000000000000000000000000000000000000000000000000000000000000000000000000000000000000000000000000000000000000000000000001
111110000100100101010001000100001000100010011000100010100010010101000001111001110101010010010100111100101110100100101010001110100111011
111111111111111111111111111111111111111111111111111111111111111111111111111111111111111111111111111111111111111111111111111111111111111
