11111
11E11
11C11
11C11
11C11
11C11
11C11
11C11
11C11
11C11
11C11
11C11
11C11
11C11
11C11
11C11
11C11
11C11
11C11
11C11
11C11
11C11
11C11
11C11
11C11
11C11
11C11
11C11
11C11
11C11
11C11
11C11
11C11
11C11
11C11
11C11
11C11
11C11
11C11
11C11
11C11
11C11
11C11
11P11
11111
