11111111111111111111111111111111111111111111111111111111111111111111111111111111
10000000000011110000000000000000000000000000000000000000000000000000000000000001
10111110000000011110000000000000000000000000000000000000000000000000000000000001
10100011110000000011000000000000000000000000000000000000000000000000000000000001
1010E000100000000000100000000000000000000000000000000000000000000000000000000001
10100000011000000000011000000000000000000000000000000000000000000000000000000001
10100000000110000000000111100000000000000000000000000000000000000000000000000001
10000000001001110000000000011111000000000000000000000000000000000000000000000001
10000000110000001110000000000000110000000000000000000000000000000000000000000001
10000111000000000011110000000000001000000000000000000000000000000000000000000001
11111000000000000000011100011000011000000000000000000000000000000000000000000001
10000000000000000000000100000000111000000000000000000000000000000000000000000001
10000000000000000000000100000011111110000000000000000000000000000000000000000001
10000000000000000000001100110011100000000000000000000000000000000000000000000001
10000000000000000000011100110001110000000000000000000000000000000000000000000001
10000000000000000011111100110000111000000000000000000000000000000000000000000001
10000000000000011111111100000001100000000000000000000000000000000000000000000001
10000000000000000000011100000010000000000000000000000000000000000000000000000001
10000000000000000000000011100001100000000000000000000000000000000000000000000001
100000000000000000000000000110CCC10000000000000000000000000000000000000000000001
10000000000000000000000000000111CC1000000000000000000000000000000000000000000001
100000000000000000000000000000011C0100000000000000000000000000000000000000000001
10000000000000000000000000001111000010000000000000000000000000000000000000000001
10000000000000000000000000111000000001100000000000000000000000000000000000000001
10000000000000000000000001110000000000011000000000000000000000000000000000000001
10000000000000000000000000001111100000000110000000000000000000000000000000000001
1000000000000000000000000000000001110000C001111110000000000000000000000000000001
10000000000000000000000000000000100011100000000001111111111000000000000000000001
10000000000000000000000000000011000000000000011000000000000100000000000000000001
10000000000000000000000000011100000000000000000000000000111000000000000000000001
10000000000000000000000000000111000000001110000000001111100000000000000000000001
100000000000000000000000000000001111000000000CCC00111111111111111111111000000001
10000000000000000000000000000000000011111110000000000000000000001110000111111111
10000000000000000000000000000000000000000001111100000000000000000100000000000001
1000000000000000000000000000000000000000000001111000000000000000001000000P0C0001
10000000000000000000000000000000000000000000000011110000000000000000000000000001
10000000000000000000000000000000000000000000000000011100000000000000000000000011
10000000000000000000000000000000000000000000000000001000001110000000100001110111
11111111111111111111111111111111111111111111111111111111111111111111111111111111
