11111111111111111111111111111111111111111111
10000000000000000000000000000000000000000001
10000000000E000000000000P0000000000CCCCC000C
10000000000000000000000000000000000000000001
11111111111111111111111111111111111111111111
