111111
1001
10P111
1E0C01
111111
