11111111111111
11101111111111
11101101100011
1P000000000001
11111101100011
10001101111111
10000000000001
100011011111C1
11111110001101
10000000E01101
10111110001101
10111111111101
10000000000001
11111111111111
